//  1,  2,  3,  4,  5,  6,  7,  8,  9, 10
 1: 0,  0,  1,  1,  1,  1,  1,  0,  0,  0
 2: 0,  4,  1,  1,  1,  1,  1,  5,  0,  4
 3: 1,  1,  1,  1,  1,  1,  1,  1,  1,  1
 4: 1,  1,  2,  0,  0,  0,  0,  0,  3,  1
 5: 1,  2,  0,  0,  0,  0,  4,  5,  0,  1
 6: 1,  0,  0,  0,  4,  1,  1,  2,  0,  1
 7: 1,  0,  0,  0,  1,  1,  2,  0,  0,  1
 8: 2,  0,  0,  0,  1,  1,  0,  0,  0,  3
 9: 0,  0,  0,  0,  2,  0,  0,  0,  0,  0
10: 0,  0,  0,  0,  0,  4,  0,  0,  0,  0
11: 5,  0,  0,  0,  1,  1,  0,  0,  0,  4
12: 1,  0,  0,  0,  1,  2,  0,  0,  0,  1
13: 1,  0,  0,  0,  1,  0,  0,  0,  0,  1
14: 1,  0,  0,  0,  1,  5,  0,  0,  0,  1
15: 1,  5,  0,  4,  1,  1,  5,  0,  4,  1
//Drops
9
//Player
65.0, 415.0
//Goal
255.0, 415.0
//Lily pads
20.0, 290.0, 2
160.0, 290.0, 0
300.0, 290.0, 0
//Logs
//Piranha
-40.0, 289.0, 360.0, 289.0
