//  1,  2,  3,  4,  5,  6,  7,  8,  9, 10
 1: 0,  0,  0,  0,  0,  0,  1,  1,  1,  1
 2: 0,  0,  0,  0,  0,  0,  1,  2,  0,  0
 3: 0,  0,  0,  0,  0,  0,  0,  0,  0,  0
 4: 0,  0,  1,  0,  0,  0,  5,  0,  1,  1
 5: 0,  0,  1,  0,  0,  0,  1,  0,  0,  1
 6: 0,  0,  1,  0,  0,  0,  1,  2,  0,  0
 7: 0,  0,  1,  0,  0,  0,  1,  0,  0,  0
 8: 0,  0,  1,  0,  0,  0,  1,  0,  0,  3
 9: 0,  0,  1,  0,  0,  0,  1,  2,  0,  1
10: 0,  0,  0,  0,  0,  0,  1,  0,  0,  0
11: 1,  5,  0,  0,  0,  1,  2,  0,  4,  1
12: 1,  1,  5,  0,  0,  0,  0,  4,  1,  1
13: 1,  1,  1,  5,  0,  0,  4,  1,  1,  1
14: 1,  1,  1,  1,  5,  4,  1,  1,  1,  1
15: 1,  1,  1,  1,  1,  1,  1,  1,  1,  1
//Drops
6
//Player
160.0, 400.0
//Goal
160.0, 65.0
//Lily pads
170.0, 269.0, 1
170.0, 159.0, 0
122.0, 159.0, 1
125.0, 270.0, 0
//Logs
//Piranha
32.0, 190.0, 32.0, 285.0, 84.0, 333.0, 172.0, 162.0, 127.0, 65.0, 32.0, 63.0
172.0, 118.0, 128.0, 65.0, 32.0, 64.0, 32.0, 286.0, 85.0, 333.0, 126.0, 291.0, 130.0, 221.0
//Whirlpool
277.0, 274.0, 0
288.0, 191.0, 0
