//  1,  2,  3,  4,  5,  6,  7,  8,  9, 10
 1: 1,  1,  1,  1,  1,  1,  1,  1,  1,  1
 2: 1,  0,  0,  0,  0,  0,  0,  0,  0,  1
 3: 1,  0,  0,  0,  0,  0,  0,  0,  0,  1
 4: 1,  1,  1,  1,  1,  0,  1,  0,  0,  1
 5: 1,  1,  1,  1,  1,  0,  1,  0,  0,  1
 6: 1,  1,  1,  1,  1,  0,  1,  0,  0,  1
 7: 1,  1,  1,  1,  1,  0,  1,  0,  0,  1
 8: 1,  1,  1,  1,  1,  0,  1,  0,  0,  1
 9: 1,  1,  1,  1,  1,  0,  1,  0,  0,  1
10: 1,  2,  0,  0,  1,  0,  1,  0,  0,  1
11: 1,  0,  0,  0,  3,  0,  1,  0,  0,  1
12: 1,  1,  1,  5,  0,  0,  1,  0,  0,  1
13: 1,  0,  0,  1,  1,  0,  0,  0,  0,  1
14: 1,  0,  0,  0,  0,  0,  0,  0,  0,  1
15: 1,  1,  1,  1,  1,  1,  1,  1,  1,  1
//Drops
10
//Player
66.0, 322.0
//Goal
87.0, 63.0
//Lily pads
256.0, 80.0, 2
260.0, 422.0, 2
132.0, 356.0, 0
183.0, 403.0, 0
218.0, 72.0, 0
