//  1,  2,  3,  4,  5,  6,  7,  8,  9, 10
 1: 1,  1,  1,  1,  1,  1,  1,  1,  1,  1
 2: 1,  0,  0,  0,  0,  0,  0,  0,  0,  1
 3: 1,  0,  0,  0,  0,  0,  0,  0,  0,  1
 4: 1,  1,  1,  5,  0,  3,  1,  1,  1,  1
 5: 1,  0,  0,  0,  0,  0,  0,  0,  0,  1
 6: 1,  0,  0,  0,  0,  0,  0,  0,  0,  1
 7: 1,  1,  1,  1,  1,  1,  1,  0,  1,  1
 8: 1,  1,  1,  1,  1,  1,  1,  0,  1,  1
 9: 1,  0,  0,  0,  0,  0,  0,  0,  0,  1
10: 1,  0,  0,  0,  0,  0,  0,  0,  0,  1
11: 1,  1,  0,  0,  1,  1,  1,  1,  1,  1
12: 1,  0,  0,  0,  0,  0,  0,  0,  0,  1
13: 1,  0,  0,  0,  0,  0,  0,  0,  0,  1
14: 1,  0,  0,  0,  0,  0,  0,  0,  0,  1
15: 1,  1,  1,  1,  1,  1,  1,  1,  1,  1
//Drops
13
//Player
160.0, 400.0
//Goal
241.0, 65.0
