//  1,  2,  3,  4,  5,  6,  7,  8,  9, 10
 1: 1,  0,  0,  0,  0,  0,  0,  3,  1,  1
 2: 1,  0,  0,  0,  0,  0,  0,  0,  3,  1
 3: 1,  0,  0,  0,  0,  0,  0,  0,  0,  3
 4: 1,  1,  1,  2,  0,  0,  0,  0,  0,  0
 5: 1,  0,  0,  0,  0,  0,  0,  0,  0,  0
 6: 1,  0,  0,  0,  0,  0,  0,  0,  0,  0
 7: 1,  0,  0,  0,  0,  0,  0,  0,  0,  0
 8: 1,  0,  0,  0,  1,  1,  1,  1,  0,  0
 9: 1,  0,  0,  0,  0,  0,  0,  0,  0,  0
10: 1,  0,  5,  0,  0,  0,  0,  0,  0,  0
11: 1,  0,  1,  5,  0,  0,  0,  0,  0,  4
12: 1,  0,  3,  1,  5,  0,  0,  0,  4,  1
13: 1,  0,  0,  0,  0,  0,  0,  4,  1,  1
14: 1,  0,  0,  0,  0,  0,  4,  1,  1,  1
15: 1,  0,  0,  0,  0,  4,  1,  1,  1,  1
//Drops
6
//Player
128.0, 320.0
//Goal
110.0, 56.0
//Lily pads
200.0, 75.0, 1
220.0, 112.0, 1
230.0, 168.0, 2
194.0, 310.0, 2
280.0, 199.0, 0
