//  1,  2,  3,  4,  5,  6,  7,  8,  9, 10
 1: 1,  1,  1,  1,  1,  1,  1,  1,  1,  1
 2: 0,  0,  0,  0,  0,  0,  0,  0,  0,  0
 3: 0,  0,  0,  0,  0,  0,  0,  0,  0,  0
 4: 0,  0,  0,  0,  0,  0,  0,  0,  0,  0
 5: 0,  0,  0,  0,  0,  0,  0,  0,  0,  0
 6: 0,  0,  0,  0,  0,  0,  0,  0,  0,  0
 7: 0,  0,  0,  0,  0,  0,  0,  0,  0,  0
 8: 0,  0,  0,  0,  0,  0,  0,  0,  0,  0
 9: 0,  0,  0,  0,  0,  0,  0,  0,  0,  0
10: 0,  0,  0,  0,  0,  0,  0,  0,  0,  0
11: 0,  0,  0,  0,  0,  0,  0,  0,  0,  0
12: 5,  0,  0,  0,  0,  0,  0,  0,  0,  4
13: 1,  0,  0,  0,  0,  0,  0,  0,  0,  1
14: 1,  0,  0,  0,  0,  0,  0,  0,  0,  1
15: 1,  1,  1,  1,  1,  1,  1,  1,  1,  1
//Drops
6
//Player
160.0, 400.0
//Goal
160.0, 65.0
//Lily pads
159.0, 191.0, 0
32.0, 192.0, 0
287.0, 190.0, 0
//Logs
110.0, 240.0, 90, 1
214.0, 143.0, 45, 1
51.0, 294.0, 90, 1
57.0, 98.0, 45, 1
257.0, 296.0, 90, 1
271.0, 92.0, 45, 1
128.0, 160.0, 180, 1
192.0, 224.0, 270, 1
