//  1,  2,  3,  4,  5,  6,  7,  8,  9, 10
 1: 1,  1,  1,  1,  1,  1,  1,  1,  1,  1
 2: 1,  2,  0,  0,  0,  0,  0,  0,  3,  1
 3: 2,  0,  0,  0,  0,  0,  0,  0,  0,  3
 4: 0,  0,  0,  0,  0,  0,  0,  0,  0,  0
 5: 0,  0,  0,  0,  0,  0,  0,  0,  0,  0
 6: 0,  0,  0,  0,  0,  0,  0,  0,  0,  0
 7: 0,  0,  0,  1,  1,  1,  1,  0,  0,  0
 8: 0,  0,  0,  1,  1,  1,  1,  0,  0,  0
 9: 0,  0,  0,  0,  0,  0,  0,  0,  0,  0
10: 0,  0,  0,  0,  0,  0,  0,  0,  0,  0
11: 0,  0,  0,  0,  0,  0,  0,  0,  0,  0
12: 0,  0,  0,  0,  0,  0,  0,  0,  0,  0
13: 5,  0,  0,  0,  0,  0,  0,  0,  0,  4
14: 1,  5,  0,  0,  0,  0,  0,  0,  4,  1
15: 1,  1,  1,  1,  1,  1,  1,  1,  1,  1
//Drops
7
//Player
160.0, 400.0
//Goal
160.0, 65.0
//Lily pads
//Logs
//Piranha
49.0, 145.0, 49.0, 351.0, 274.0, 350.0, 274.0, 144.0
273.0, 288.0, 273.0, 96.0, 48.0, 96.0, 48.0, 285.0
