//  1,  2,  3,  4,  5,  6,  7,  8,  9, 10
 1: 0,  0,  1,  0,  0,  0,  0,  1,  0,  0
 2: 0,  0,  1,  0,  0,  0,  0,  1,  0,  0
 3: 0,  0,  1,  0,  0,  0,  0,  1,  0,  0
 4: 0,  0,  2,  0,  0,  0,  0,  3,  0,  0
 5: 0,  0,  0,  0,  0,  0,  0,  0,  0,  0
 6: 0,  0,  0,  0,  0,  0,  0,  0,  0,  0
 7: 0,  0,  0,  0,  0,  0,  0,  0,  0,  0
 8: 0,  0,  0,  0,  0,  0,  0,  0,  0,  0
 9: 0,  0,  0,  0,  0,  0,  0,  0,  0,  0
10: 0,  0,  0,  0,  0,  0,  0,  0,  0,  0
11: 0,  0,  0,  0,  0,  0,  0,  0,  0,  0
12: 0,  0,  0,  0,  0,  0,  0,  0,  0,  0
13: 0,  0,  0,  0,  0,  0,  0,  0,  0,  0
14: 0,  0,  0,  0,  0,  0,  0,  0,  0,  0
15: 0,  0,  0,  0,  0,  0,  0,  0,  0,  0
//Drops
10
//Player
160.0, 400.0
//Goal
160.0, 65.0
//Lily pads
160.0, 160.0, 2
//Logs
93.0, 193.0, 45, 0
227.0, 193.0, 135, 0
93.0, 327.0, 135, 0
227.0, 327.0, 45, 0
160.0, 260.0, 135, 1
25.0, 126.0, 45, 0
295.0, 395.0, 45, 0
