//  1,  2,  3,  4,  5,  6,  7,  8,  9, 10
 1: 1,  1,  1,  1,  1,  1,  1,  1,  1,  1
 2: 1,  0,  0,  0,  0,  0,  0,  0,  0,  1
 3: 1,  0,  0,  0,  0,  0,  0,  0,  0,  1
 4: 1,  0,  0,  0,  0,  0,  0,  0,  0,  1
 5: 1,  0,  0,  0,  0,  0,  0,  0,  0,  1
 6: 1,  0,  0,  0,  0,  0,  0,  0,  0,  1
 7: 1,  0,  0,  0,  0,  0,  0,  0,  0,  1
 8: 1,  0,  0,  0,  0,  0,  0,  0,  0,  1
 9: 1,  0,  0,  0,  0,  0,  0,  0,  0,  1
10: 1,  0,  0,  0,  0,  0,  0,  0,  1,  1
11: 1,  1,  0,  0,  0,  0,  0,  0,  0,  1
12: 1,  0,  0,  0,  0,  0,  0,  0,  0,  1
13: 1,  0,  0,  0,  0,  0,  0,  0,  0,  1
14: 1,  0,  0,  0,  0,  0,  0,  0,  0,  1
15: 1,  1,  1,  1,  1,  1,  1,  1,  1,  1
//Drops
8
//Player
160.0, 400.0
//Goal
256.0, 159.0
//Lily pads
//Logs
112.0, 360.0, 315, 0
120.0, 265.0, 315, 1
209.0, 208.0, 90, 0
130.0, 144.0, 315, 0
210.0, 305.0, 45, 0
