//  1,  2,  3,  4,  5,  6,  7,  8,  9, 10
 1: 1,  1,  1,  1,  1,  1,  1,  1,  1,  1
 2: 1,  0,  0,  1,  1,  2,  3,  1,  1,  1
 3: 1,  0,  0,  3,  1,  0,  0,  3,  1,  1
 4: 1,  1,  5,  0,  3,  0,  0,  0,  3,  1
 5: 1,  2,  0,  0,  0,  0,  0,  0,  0,  1
 6: 1,  5,  0,  0,  0,  0,  0,  0,  0,  1
 7: 1,  1,  5,  0,  0,  0,  0,  0,  0,  1
 8: 1,  1,  1,  5,  0,  0,  0,  0,  0,  1
 9: 1,  1,  1,  2,  0,  0,  0,  0,  0,  1
10: 1,  1,  2,  0,  0,  0,  0,  0,  0,  1
11: 1,  2,  0,  0,  0,  0,  0,  0,  0,  1
12: 1,  0,  0,  0,  0,  0,  0,  0,  0,  1
13: 1,  0,  0,  0,  0,  0,  0,  0,  0,  1
14: 1,  0,  0,  0,  0,  0,  0,  0,  0,  1
15: 1,  1,  1,  1,  1,  1,  1,  1,  1,  1
//Drops
6
//Player
95.0, 392.0
//Goal
 75.0, 75.0
//Lily pads
184.0, 200.0, 2
221.0, 282.0, 0
246.0, 418.0, 2
246.0, 211.0, 2
//Logs
//Piranha
272.0, 351.0, 154.0, 351.0, 154.0, 234.0, 271.0, 168.0
153.0, 232.0, 270.0, 170.0, 273.0, 352.0, 155.0, 419.0, 100.0, 382.0
