//  1,  2,  3,  4,  5,  6,  7,  8,  9, 10
 1: 1,  1,  1,  1,  1,  1,  1,  1,  1,  1
 2: 1,  1,  2,  3,  1,  1,  2,  3,  1,  1
 3: 1,  1,  0,  0,  3,  1,  0,  0,  1,  2
 4: 1,  1,  0,  0,  0,  3,  0,  0,  2,  0
 5: 1,  1,  0,  0,  0,  0,  0,  0,  0,  0
 6: 1,  1,  0,  1,  1,  1,  0,  3,  1,  1
 7: 1,  1,  0,  0,  0,  0,  0,  0,  0,  0
 8: 1,  1,  0,  0,  0,  0,  0,  0,  0,  0
 9: 1,  1,  0,  0,  0,  1,  0,  0,  1,  0
10: 5,  4,  0,  3,  1,  1,  0,  0,  1,  1
11: 3,  2,  0,  0,  0,  1,  0,  0,  1,  0
12: 1,  1,  0,  0,  0,  1,  0,  0,  1,  0
13: 1,  1,  5,  0,  0,  2,  0,  0,  3,  0
14: 1,  1,  1,  5,  0,  0,  0,  0,  0,  0
15: 1,  1,  1,  1,  5,  0,  4,  5,  0,  0
//Drops
8
//Player
278.0, 450.0
//Gole
 99.0, 64.0
//Lily pads
135.0, 205.0, 0
295.0, 205.0, 0
//Logs
210.0, 255.0, 180, 1
210.0, 375.0, 0, 1
