//  1,  2,  3,  4,  5,  6,  7,  8,  9, 10
 1: 1,  1,  1,  1,  1,  1,  1,  1,  1,  1
 2: 1,  0,  0,  0,  0,  0,  0,  0,  0,  1
 3: 1,  0,  0,  0,  0,  0,  0,  0,  0,  1
 4: 1,  0,  0,  0,  0,  0,  0,  0,  0,  1
 5: 1,  0,  0,  0,  0,  0,  0,  0,  0,  1
 6: 1,  0,  0,  0,  0,  0,  0,  0,  0,  1
 7: 1,  0,  0,  0,  0,  0,  0,  0,  0,  1
 8: 1,  0,  0,  0,  0,  0,  0,  0,  0,  1
 9: 1,  0,  0,  0,  0,  0,  0,  0,  0,  1
10: 1,  0,  0,  0,  0,  0,  0,  0,  0,  1
11: 1,  0,  0,  0,  0,  0,  0,  0,  0,  1
12: 1,  0,  0,  0,  0,  0,  0,  0,  0,  1
13: 1,  0,  0,  0,  0,  0,  0,  0,  0,  1
14: 1,  0,  0,  0,  0,  0,  0,  0,  0,  1
15: 1,  1,  1,  1,  1,  1,  1,  1,  1,  1
//Drops
7
//Player
159.0, 399.0
//Goal
206.0, 95.0
//Lily pads
//Logs
113.0, 370.0, 90, 0
177.0, 303.0, 0, 1
81.0, 273.0, 135, 0
274.0, 273.0, 0, 1
187.0, 145.0, 0, 0
176.0, 241.0, 45, 0
71.0, 164.0, 315, 0
