//  1,  2,  3,  4,  5,  6,  7,  8,  9, 10
 1: 1,  1,  1,  1,  1,  1,  1,  1,  1,  1
 2: 1,  0,  0,  0,  0,  0,  0,  0,  0,  1
 3: 1,  0,  0,  0,  5,  0,  0,  4,  0,  1
 4: 1,  0,  0,  0,  1,  0,  0,  1,  0,  1
 5: 1,  0,  0,  0,  1,  0,  4,  1,  0,  1
 6: 1,  0,  0,  0,  1,  0,  3,  1,  0,  1
 7: 1,  0,  0,  0,  0,  0,  0,  3,  1,  1
 8: 1,  0,  0,  0,  0,  0,  0,  0,  3,  1
 9: 1,  0,  0,  0,  0,  0,  0,  0,  0,  1
10: 1,  0,  0,  0,  0,  0,  0,  0,  0,  1
11: 1,  1,  1,  5,  0,  0,  3,  1,  1,  1
12: 1,  0,  0,  0,  0,  0,  0,  0,  0,  1
13: 1,  0,  0,  0,  0,  0,  0,  0,  0,  1
14: 1,  0,  0,  0,  0,  0,  0,  0,  0,  1
15: 1,  1,  1,  1,  1,  1,  1,  1,  1,  1
//Drops
7
//Player
250.0, 400.0
//Goal
272.0,  42.0
//Lily pads
 109.0, 208.0, 0
 94.0, 106.0, 2
 55.0, 275.0, 2
108.0,  58.0, 2
 85.0, 158.0, 2
//Logs
130.0,  280.0, -45, 1

