//  1,  2,  3,  4,  5,  6,  7,  8,  9, 10
 1: 0,  0,  0,  0,  0,  0,  0,  0,  0,  0
 2: 0,  0,  0,  0,  0,  0,  0,  0,  0,  0
 3: 0,  0,  0,  0,  0,  0,  0,  0,  0,  0
 4: 0,  0,  0,  0,  0,  0,  0,  0,  0,  0
 5: 0,  0,  1,  0,  0,  0,  0,  1,  0,  0
 6: 0,  0,  1,  0,  0,  0,  0,  1,  0,  0
 7: 0,  0,  1,  1,  1,  1,  1,  1,  0,  0
 8: 0,  0,  0,  0,  0,  0,  0,  0,  0,  0
 9: 0,  0,  1,  0,  0,  0,  0,  1,  0,  0
10: 0,  0,  1,  0,  0,  0,  0,  1,  0,  0
11: 0,  0,  3,  0,  0,  0,  0,  2,  0,  0
12: 0,  0,  0,  0,  0,  0,  0,  0,  0,  0
13: 0,  0,  0,  0,  0,  0,  0,  0,  0,  0
14: 0,  0,  0,  0,  0,  0,  0,  0,  0,  0
15: 0,  0,  4,  1,  1,  1,  1,  5,  0,  0
//Drops
9
//Player
160.0, 400.0
//Goal
161.0, 161.0
//Lily pads
104.0, 415.0, 2
215.0, 415.0, 2
33.0, 380.0, 2
288.0, 380.0, 2
33.0, 310.0, 2
288.0, 320.0, 2
//Logs
30.0, 422.0, 45, 0
290.0, 420.0, 135, 0
33.0, 64.0, 90, 1
288.0, 64.0, 90, 1
