//  1,  2,  3,  4,  5,  6,  7,  8,  9, 10
 1: 1,  1,  1,  1,  1,  1,  1,  1,  1,  1
 2: 1,  1,  1,  1,  1,  1,  1,  1,  1,  1
 3: 1,  1,  1,  1,  1,  1,  1,  1,  1,  1
 4: 1,  1,  1,  1,  1,  1,  1,  1,  1,  1
 5: 1,  1,  1,  1,  1,  1,  1,  1,  1,  1
 6: 1,  1,  1,  1,  1,  1,  1,  1,  1,  1
 7: 1,  1,  1,  1,  1,  1,  1,  1,  1,  1
 8: 1,  1,  1,  1,  1,  1,  1,  1,  1,  1
 9: 1,  0,  0,  0,  0,  0,  0,  0,  0,  1
10: 1,  0,  0,  0,  0,  0,  0,  0,  0,  1
11: 1,  0,  0,  0,  0,  0,  0,  0,  0,  1
12: 1,  0,  0,  0,  0,  0,  0,  0,  0,  1
13: 1,  0,  0,  0,  0,  0,  0,  0,  0,  1
14: 1,  0,  0,  0,  0,  0,  0,  0,  0,  1
15: 1,  1,  1,  1,  1,  1,  1,  1,  1,  1
//Drops
10
//Player
84.0, 390.0
//Goal
241.0, 293.0
