//  1,  2,  3,  4,  5,  6,  7,  8,  9, 10
 1: 0,  0,  0,  0,  0,  0,  3,  1,  1,  1
 2: 0,  0,  0,  0,  0,  0,  0,  0,  3,  1
 3: 0,  0,  0,  0,  0,  0,  0,  0,  0,  1
 4: 0,  0,  4,  2,  0,  5,  0,  0,  0,  3
 5: 0,  0,  0,  0,  0,  1,  0,  0,  0,  0
 6: 0,  0,  0,  0,  0,  1,  0,  0,  0,  0
 7: 0,  0,  0,  0,  0,  0,  0,  0,  0,  0
 8: 0,  0,  5,  0,  0,  0,  0,  0,  0,  0
 9: 0,  0,  1,  5,  0,  0,  0,  0,  0,  0
10: 0,  0,  2,  0,  0,  0,  0,  0,  0,  0
11: 0,  0,  0,  0,  0,  5,  0,  0,  0,  0
12: 0,  0,  4,  0,  0,  1,  0,  0,  0,  1
13: 0,  0,  1,  0,  0,  0,  0,  0,  0,  1
14: 0,  0,  0,  0,  0,  0,  0,  0,  0,  1
15: 0,  0,  1,  0,  0,  1,  0,  0,  0,  1
//Drops
6
//Player
118.0, 410.0
//Goal
98.0, 64.0
//Lily pads
 47.0, 431.0, 2
 43.0, 161.0, 0
 52.0, 358.0, 2
265.0, 376.0, 0
//Logs
176.0, 293.0, 90, 0
265.0, 197.0, 0, 1
//Piranha
19.0, 51.0, 128.0, 223.0, 290.0, 224.0, 253.0, 65.0, 182.0, 17.0, 47.0, 17.0
//Whirlpool
251.0, 424.0, 0
