//  1,  2,  3,  4,  5,  6,  7,  8,  9, 10
 1: 0,  0,  0,  0,  0,  0,  0,  0,  0,  0
 2: 0,  0,  0,  0,  0,  0,  0,  0,  0,  0
 3: 0,  0,  1,  1,  1,  1,  1,  5,  0,  0
 4: 0,  0,  0,  0,  0,  0,  0,  0,  0,  0
 5: 0,  0,  0,  0,  0,  0,  0,  0,  0,  0
 6: 0,  0,  5,  0,  0,  0,  0,  0,  0,  0
 7: 0,  0,  1,  0,  0,  4,  5,  0,  0,  0
 8: 0,  0,  1,  5,  0,  3,  1,  5,  0,  0
 9: 0,  0,  3,  1,  5,  0,  3,  1,  0,  0
10: 0,  0,  0,  0,  0,  0,  0,  1,  0,  0
11: 0,  0,  1,  1,  2,  0,  0,  1,  0,  0
12: 0,  0,  1,  2,  0,  0,  4,  2,  0,  0
13: 0,  0,  0,  0,  0,  0,  0,  0,  0,  0
14: 0,  0,  1,  1,  1,  0,  0,  0,  0,  0
15: 0,  0,  2,  0,  0,  0,  0,  0,  0,  0
//Drops
9
//Player
280.0, 435.0
//Gole
35.0, 32.0
//Lily pads
280.0,  20.0, 0
100.0, 150.0, 0
135.0,  43.0, 0
276.0,  335.0, 0
//Logs
 25.0, 405.0, 90, 1
215.0, 140.0, 90, 1
