//  1,  2,  3,  4,  5,  6,  7,  8,  9, 10
 1: 1,  1,  1,  1,  1,  1,  1,  1,  1,  1
 2: 1,  0,  0,  0,  0,  0,  0,  0,  0,  1
 3: 1,  0,  0,  0,  0,  0,  0,  0,  0,  1
 4: 1,  0,  1,  1,  1,  1,  1,  1,  1,  1
 5: 1,  0,  0,  2,  0,  0,  0,  0,  0,  1
 6: 1,  0,  0,  0,  0,  0,  4,  0,  0,  1
 7: 1,  1,  1,  1,  1,  1,  1,  5,  3,  1
 8: 1,  0,  0,  0,  3,  0,  0,  0,  0,  1
 9: 1,  0,  0,  0,  0,  4,  0,  0,  0,  1
10: 1,  2,  4,  1,  1,  1,  1,  1,  1,  1
11: 1,  0,  1,  2,  0,  0,  0,  0,  0,  1
12: 1,  0,  1,  0,  0,  0,  0,  1,  0,  1
13: 1,  0,  3,  1,  1,  1,  1,  2,  0,  1
14: 1,  0,  0,  0,  0,  0,  0,  0,  0,  1
15: 1,  1,  1,  1,  1,  1,  1,  1,  1,  1
//Drops
25
//Player
146.0, 351.0
//Gole
256.0, 62.0
