//  1,  2,  3,  4,  5,  6,  7,  8,  9, 10
 1: 0,  0,  0,  0,  0,  0,  0,  0,  0,  0
 2: 0,  0,  0,  0,  0,  0,  0,  0,  0,  0
 3: 0,  0,  0,  0,  0,  0,  4,  0,  0,  0
 4: 0,  0,  0,  5,  0,  0,  1,  0,  0,  0
 5: 0,  0,  0,  1,  1,  1,  1,  0,  0,  0
 6: 0,  0,  0,  1,  0,  0,  1,  0,  0,  0
 7: 0,  0,  0,  3,  0,  0,  2,  0,  0,  0
 8: 0,  0,  0,  0,  0,  0,  0,  0,  0,  0
 9: 0,  0,  0,  0,  0,  0,  0,  0,  0,  0
10: 0,  0,  0,  0,  0,  0,  0,  0,  0,  0
11: 0,  0,  0,  0,  0,  0,  0,  0,  0,  0
12: 0,  0,  0,  0,  0,  0,  0,  0,  0,  0
13: 0,  0,  0,  0,  0,  0,  0,  0,  0,  0
14: 0,  0,  0,  0,  0,  0,  0,  0,  0,  0
15: 0,  0,  0,  0,  0,  0,  0,  0,  0,  0
//Drops
7
//Player
160.0, 433.0
//Goal
161.0, 104.0
//Lily pads
247.0, 135.0, 1
220.0, 25.0, 1
287.0, 179.0, 1
224.0, 227.0, 1
//Logs
21.0, 247.0, 90, 0
300.0, 250.0, 90, 0
21.0, 349.0, 90, 0
300.0, 350.0, 90, 0
//Piranha
//Whirlpool
68.0, 90.0, 0
110.0, 298.0, 0
208.0, 297.0, 0
30.0, 158.0, 1
