//  1,  2,  3,  4,  5,  6,  7,  8,  9, 10
 1: 1,  1,  1,  1,  1,  1,  1,  1,  1,  1
 2: 1,  2,  1,  0,  0,  0,  3,  0,  0,  1
 3: 1,  0,  1,  0,  0,  5,  0,  0,  0,  1
 4: 1,  0,  2,  0,  4,  1,  5,  0,  0,  1
 5: 1,  0,  0,  4,  1,  0,  3,  5,  0,  1
 6: 1,  0,  0,  0,  3,  5,  0,  3,  1,  1
 7: 1,  4,  1,  5,  0,  3,  5,  0,  3,  1
 8: 1,  1,  1,  1,  5,  0,  3,  5,  0,  1
 9: 1,  1,  1,  1,  1,  5,  0,  3,  5,  1
10: 1,  1,  2,  0,  0,  3,  5,  0,  3,  1
11: 1,  1,  0,  0,  5,  0,  3,  0,  4,  1
12: 1,  3,  5,  0,  3,  5,  0,  0,  3,  1
13: 1,  0,  3,  5,  0,  3,  5,  0,  4,  1
14: 1,  5,  0,  0,  0,  0,  3,  1,  1,  1
15: 1,  1,  1,  1,  1,  1,  1,  1,  1,  1
//Drops
15
//Player
52.0, 407.0
//Gole
257.0, 64.0
