//  1,  2,  3,  4,  5,  6,  7,  8,  9, 10
 1: 0,  0,  0,  0,  0,  0,  0,  0,  0,  0
 2: 0,  0,  0,  0,  0,  0,  0,  0,  0,  0
 3: 0,  0,  0,  0,  0,  0,  0,  0,  0,  0
 4: 1,  1,  5,  0,  0,  0,  0,  4,  1,  1
 5: 0,  0,  0,  0,  0,  0,  0,  0,  0,  0
 6: 0,  0,  0,  0,  0,  0,  0,  0,  0,  0
 7: 0,  0,  0,  0,  0,  0,  0,  0,  0,  0
 8: 5,  0,  0,  0,  0,  0,  0,  0,  0,  4
 9: 1,  5,  0,  0,  0,  0,  0,  0,  4,  1
10: 1,  1,  5,  0,  0,  0,  0,  4,  1,  1
11: 1,  1,  1,  0,  0,  0,  0,  1,  1,  1
12: 1,  1,  1,  0,  0,  0,  0,  1,  1,  1
13: 1,  1,  2,  0,  0,  0,  0,  3,  1,  1
14: 1,  2,  0,  0,  0,  0,  0,  0,  3,  1
15: 2,  0,  0,  0,  0,  0,  0,  0,  0,  3
//Drops
10
//Player
160.0, 400.0
//Goal
161.0, 40.0
//Lily pads
145.0, 168.0, 0
175.0, 168.0, 0
//Logs
//Piranha
26.0, 160.0, 305.0, 160.0
218.0, 194.0, 308.0, 194.0
106.0, 193.0, 25.0, 194.0
