//  1,  2,  3,  4,  5,  6,  7,  8,  9, 10
 1: 1,  1,  1,  1,  1,  1,  1,  1,  1,  1
 2: 1,  1,  1,  1,  2,  0,  3,  1,  1,  1
 3: 1,  1,  2,  0,  0,  0,  0,  0,  3,  1
 4: 1,  1,  0,  4,  1,  1,  5,  0,  0,  1
 5: 1,  2,  0,  1,  1,  1,  1,  5,  4,  1
 6: 1,  0,  4,  1,  2,  3,  1,  1,  1,  1
 7: 1,  0,  1,  1,  0,  0,  0,  3,  1,  1
 8: 2,  0,  1,  2,  0,  1,  5,  0,  1,  1
 9: 5,  0,  1,  0,  4,  1,  1,  0,  3,  1
10: 1,  0,  1,  0,  0,  0,  1,  5,  0,  1
11: 1,  0,  1,  5,  0,  4,  1,  2,  0,  1
12: 2,  0,  1,  1,  1,  1,  0,  0,  4,  1
13: 5,  0,  3,  1,  1,  2,  0,  3,  1,  1
14: 1,  5,  0,  0,  0,  0,  4,  1,  1,  1
15: 1,  1,  1,  5,  4,  1,  1,  1,  1,  1
//Drops
19
//Player
149.0, 320.0
//Goal
255.0, 113.0
