//  1,  2,  3,  4,  5,  6,  7,  8,  9, 10
 1: 1,  1,  0,  0,  0,  0,  0,  0,  1,  1
 2: 1,  1,  0,  0,  0,  0,  0,  0,  1,  1
 3: 1,  1,  0,  0,  0,  0,  0,  0,  1,  1
 4: 1,  1,  0,  0,  0,  0,  0,  0,  1,  1
 5: 1,  1,  0,  0,  0,  0,  0,  0,  1,  1
 6: 1,  1,  0,  0,  0,  0,  0,  0,  1,  1
 7: 1,  1,  0,  0,  0,  0,  0,  0,  1,  1
 8: 1,  1,  0,  0,  0,  0,  0,  0,  1,  1
 9: 1,  1,  0,  0,  0,  0,  0,  0,  1,  1
10: 1,  1,  0,  0,  0,  0,  0,  0,  1,  1
11: 1,  1,  0,  0,  0,  0,  0,  0,  1,  1
12: 1,  1,  0,  0,  0,  0,  0,  0,  1,  1
13: 1,  1,  0,  0,  0,  0,  0,  0,  1,  1
14: 1,  1,  0,  0,  0,  0,  0,  0,  1,  1
15: 1,  1,  0,  0,  0,  0,  0,  0,  1,  1
//Drops
6
//Player
160.0, 435.0
//Goal
159.0, 35.0
//Lily pads
//Logs
132.0, 109.0, 90, 1
215.0, 364.0, 45, 1
//Piranha
32.0, 194.0, 295.0, 191.0
//Whirlpool
191.0, 251.0, 0
217.0, 36.0, 0
129.0, 322.0, 0
