//  1,  2,  3,  4,  5,  6,  7,  8,  9, 10
 1: 1,  1,  1,  0,  1,  0,  1,  0,  1,  1
 2: 0,  1,  0,  0,  1,  0,  1,  0,  1,  0
 3: 0,  1,  0,  0,  1,  1,  1,  0,  1,  1
 4: 0,  1,  0,  0,  1,  0,  1,  0,  1,  0
 5: 0,  1,  0,  0,  1,  0,  1,  0,  1,  1
 6: 0,  0,  0,  0,  0,  0,  0,  0,  0,  0
 7: 1,  1,  1,  1,  1,  1,  1,  1,  1,  1
 8: 0,  0,  0,  0,  0,  0,  0,  0,  0,  0
 9: 1,  1,  0,  0,  0,  0,  0,  0,  0,  1
10: 1,  0,  0,  1,  0,  0,  0,  0,  0,  1
11: 1,  1,  0,  1,  1,  1,  0,  1,  1,  1
12: 1,  0,  0,  1,  0,  1,  0,  1,  0,  1
13: 1,  1,  0,  1,  0,  1,  0,  1,  1,  1
14: 0,  0,  0,  0,  0,  0,  0,  0,  0,  0
15: 0,  0,  0,  0,  0,  0,  0,  0,  0,  0
//Drops
99
//Player
167.0, 458.0
//Goal
97.0, 60.0
