//  1,  2,  3,  4,  5,  6,  7,  8,  9, 10
 1: 1,  1,  1,  1,  1,  1,  1,  1,  1,  1
 2: 1,  1,  1,  0,  0,  0,  0,  1,  1,  1
 3: 1,  1,  1,  5,  0,  0,  0,  3,  1,  1
 4: 1,  2,  3,  2,  4,  5,  0,  0,  3,  1
 5: 1,  0,  0,  0,  3,  2,  0,  0,  0,  1
 6: 1,  0,  0,  0,  0,  0,  0,  0,  0,  1
 7: 1,  5,  0,  0,  0,  0,  0,  0,  4,  1
 8: 1,  1,  5,  0,  0,  0,  0,  4,  1,  1
 9: 1,  1,  2,  0,  0,  0,  0,  3,  1,  1
10: 1,  2,  0,  0,  4,  5,  0,  0,  3,  1
11: 1,  0,  0,  0,  3,  2,  0,  0,  0,  1
12: 1,  0,  3,  5,  0,  0,  4,  5,  0,  1
13: 1,  5,  0,  3,  0,  0,  3,  2,  4,  1
14: 1,  1,  5,  0,  0,  0,  0,  4,  1,  1
15: 1,  1,  1,  1,  1,  1,  1,  1,  1,  1
//Drops
9
//Player
140.0, 410.0
//Goal
160.0,  80.0
//Lily pads
127.0, 110.0, 0 
153.0, 180.0, 0
226.0, 280.0, 0
//Logs
240.0, 180.0, 45, 1
 72.0, 300.0, 45, 1
