//  1,  2,  3,  4,  5,  6,  7,  8,  9, 10
 1: 0,  0,  0,  0,  1,  0,  0,  3,  1,  1
 2: 0,  0,  0,  0,  2,  0,  0,  0,  3,  1
 3: 0,  0,  0,  0,  0,  0,  0,  0,  0,  3
 4: 0,  0,  0,  0,  4,  0,  1,  0,  0,  0
 5: 0,  0,  0,  0,  1,  0,  3,  0,  0,  0
 6: 0,  0,  0,  0,  1,  5,  0,  0,  0,  0
 7: 1,  1,  1,  1,  1,  1,  0,  3,  5,  0
 8: 0,  0,  0,  0,  0,  0,  0,  0,  1,  0
 9: 0,  0,  0,  0,  0,  0,  0,  0,  2,  0
10: 0,  0,  0,  0,  0,  0,  0,  0,  0,  0
11: 0,  0,  0,  1,  1,  1,  5,  0,  0,  0
12: 0,  0,  0,  1,  0,  0,  1,  0,  0,  0
13: 0,  0,  0,  0,  0,  0,  1,  0,  0,  0
14: 0,  0,  0,  0,  0,  0,  1,  0,  0,  0
15: 0,  0,  0,  0,  0,  0,  1,  0,  0,  0
//Drops
11
//Player
135.0, 410.0
//Gole
 68.0, 50.0
//Lily pads
198.0, 255.0, 0
//Logs
 68.0, 420.0, -45, 1
120.0, 125.0, 90, 1
262.0, 340.0, 90, 1
 46.0, 270.0, -45, 0
