//  1,  2,  3,  4,  5,  6,  7,  8,  9, 10
 1: 1,  1,  1,  1,  1,  1,  1,  1,  1,  1
 2: 1,  2,  0,  0,  0,  0,  0,  0,  0,  1
 3: 1,  0,  0,  0,  0,  0,  0,  0,  0,  1
 4: 1,  0,  0,  0,  1,  0,  0,  0,  4,  1
 5: 1,  0,  0,  0,  1,  1,  1,  1,  1,  1
 6: 1,  0,  0,  0,  0,  0,  1,  1,  1,  1
 7: 1,  1,  1,  1,  0,  0,  1,  1,  1,  1
 8: 1,  1,  1,  1,  0,  0,  1,  1,  1,  1
 9: 1,  1,  1,  1,  0,  0,  1,  1,  1,  1
10: 1,  0,  0,  0,  0,  0,  0,  0,  0,  1
11: 1,  0,  0,  0,  0,  0,  0,  0,  0,  1
12: 1,  0,  0,  0,  0,  0,  0,  0,  0,  1
13: 1,  0,  0,  0,  0,  0,  0,  0,  0,  1
14: 1,  0,  0,  0,  0,  0,  0,  0,  0,  1
15: 1,  1,  1,  1,  1,  1,  1,  1,  1,  1
//Drops
10
//Player
160.0, 400.0
//Goal
235.0, 65.0
//Lily pads
//Logs
180.0, 280.0,   0, 1
 70.0,  75.0, 135, 0
