//  1,  2,  3,  4,  5,  6,  7,  8,  9, 10
 1: 0,  0,  0,  0,  0,  0,  0,  0,  0,  0
 2: 0,  0,  0,  0,  0,  0,  0,  0,  0,  0
 3: 0,  0,  0,  0,  0,  0,  1,  1,  0,  0
 4: 0,  0,  0,  0,  0,  0,  0,  1,  0,  0
 5: 0,  0,  0,  0,  1,  5,  0,  1,  0,  0
 6: 0,  0,  0,  0,  0,  1,  0,  1,  0,  0
 7: 1,  0,  0,  0,  0,  1,  0,  1,  0,  0
 8: 1,  0,  0,  0,  0,  0,  0,  1,  0,  0
 9: 1,  0,  0,  0,  0,  0,  0,  1,  0,  0
10: 1,  0,  0,  5,  0,  0,  0,  1,  0,  0
11: 1,  0,  0,  1,  0,  0,  0,  1,  0,  0
12: 1,  0,  0,  1,  1,  1,  1,  1,  0,  0
13: 1,  0,  0,  0,  0,  0,  0,  0,  0,  0
14: 1,  0,  0,  0,  0,  0,  0,  0,  0,  0
15: 1,  0,  0,  0,  0,  0,  0,  0,  0,  0
//Drops
8
//Player
236.0, 437.0
//Goal
160.0, 65.0
//Lily pads
317.0, 316.0, 0
260.0, 219.0, 0
315.0, 143.0, 0
//Logs
75.0, 177.0, 135, 0
//Piranha
//Whirlpool
104.0, 33.0, 1
167.0, 258.0, 1

