//  1,  2,  3,  4,  5,  6,  7,  8,  9, 10
 1: 0,  0,  0,  0,  0,  0,  0,  0,  0,  0
 2: 0,  0,  0,  0,  0,  0,  0,  0,  0,  0
 3: 0,  0,  0,  0,  0,  0,  0,  0,  0,  0
 4: 0,  0,  0,  0,  0,  1,  0,  0,  0,  0
 5: 0,  0,  0,  0,  0,  0,  0,  0,  0,  0
 6: 0,  0,  0,  0,  0,  0,  0,  0,  0,  0
 7: 0,  0,  1,  0,  0,  0,  0,  0,  0,  0
 8: 0,  0,  0,  0,  0,  0,  0,  0,  0,  0
 9: 0,  0,  0,  0,  1,  1,  0,  0,  0,  0
10: 0,  0,  0,  0,  0,  0,  0,  0,  0,  0
11: 0,  0,  0,  0,  0,  0,  0,  0,  0,  0
12: 0,  0,  0,  0,  0,  0,  0,  0,  0,  0
13: 5,  0,  0,  0,  0,  0,  0,  0,  0,  4
14: 1,  5,  0,  0,  0,  0,  0,  0,  4,  1
15: 1,  1,  1,  1,  1,  1,  1,  1,  1,  1
//Drops
6
//Player
160.0, 400.0
//Goal
160.0, 65.0
//Lily pads
//Logs
//Piranha
25.0, 353.0, 255.0, 320.0, 253.0, 191.0, 100.0, 225.0
289.0, 126.0, 25.0, 186.0, 99.0, 368.0, 288.0, 222.0
//Whirlpool
96.0, 285.0, 1
219.0, 228.0, 0
201.0, 108.0, 1
123.0, 107.0, 0
