//  1,  2,  3,  4,  5,  6,  7,  8,  9, 10
 1: 1,  1,  1,  1,  1,  1,  1,  1,  1,  1
 2: 1,  0,  0,  0,  0,  0,  0,  0,  0,  1
 3: 1,  0,  0,  0,  0,  0,  0,  0,  0,  1
 4: 1,  0,  0,  0,  0,  0,  0,  0,  0,  1
 5: 1,  0,  0,  0,  4,  5,  0,  0,  0,  1
 6: 1,  0,  0,  4,  1,  1,  5,  0,  0,  1
 7: 1,  0,  0,  1,  1,  1,  1,  0,  0,  1
 8: 1,  0,  0,  1,  1,  1,  1,  0,  0,  1
 9: 1,  0,  0,  1,  1,  1,  1,  0,  0,  1
10: 1,  0,  0,  0,  0,  0,  1,  0,  0,  1
11: 1,  0,  0,  0,  0,  0,  1,  0,  0,  1
12: 1,  0,  0,  0,  0,  0,  1,  0,  0,  1
13: 1,  5,  0,  0,  0,  0,  1,  0,  0,  1
14: 1,  1,  5,  0,  0,  0,  1,  0,  0,  1
15: 1,  1,  1,  1,  1,  1,  1,  1,  1,  1
//Drops
10
//Player
257.0, 373.0
//Goal
144.0, 326.0
//Lily pads
//Logs
//Piranha
//Whirlpool
174.0, 96.0, 1
92.0, 326.0, 1
