//  1,  2,  3,  4,  5,  6,  7,  8,  9, 10
 1: 1,  1,  1,  1,  1,  1,  1,  1,  1,  1
 2: 1,  1,  2,  1,  1,  1,  1,  3,  1,  1
 3: 1,  2,  0,  1,  1,  1,  1,  0,  3,  1
 4: 1,  0,  0,  1,  1,  1,  1,  0,  0,  1
 5: 1,  0,  0,  0,  0,  0,  0,  0,  0,  1
 6: 1,  0,  1,  5,  0,  0,  4,  1,  0,  1
 7: 1,  0,  3,  1,  5,  0,  1,  2,  0,  1
 8: 1,  5,  0,  0,  0,  0,  2,  0,  4,  1
 9: 1,  2,  0,  4,  0,  0,  0,  0,  3,  0
10: 1,  0,  4,  1,  0,  3,  1,  5,  0,  1
11: 1,  0,  1,  2,  0,  0,  3,  1,  0,  1
12: 1,  0,  0,  0,  0,  0,  0,  0,  0,  1
13: 1,  0,  1,  0,  1,  1,  0,  1,  0,  1
14: 1,  0,  0,  4,  1,  1,  5,  0,  0,  1
15: 1,  1,  1,  1,  1,  1,  1,  1,  1,  1
//Drops
10
//Player
112.0, 399.0
//Goal
160.0, 160.0
//Lily pads
160.0, 255.0, 2
176.0, 334.0, 2
