//  1,  2,  3,  4,  5,  6,  7,  8,  9, 10
 1: 1,  1,  0,  0,  0,  0,  0,  0,  1,  1
 2: 1,  1,  0,  0,  0,  0,  0,  0,  1,  1
 3: 1,  1,  0,  0,  0,  0,  0,  0,  1,  1
 4: 1,  1,  0,  0,  0,  0,  0,  0,  1,  1
 5: 1,  2,  0,  0,  0,  0,  0,  0,  3,  1
 6: 1,  0,  0,  0,  4,  5,  0,  0,  0,  1
 7: 1,  0,  0,  0,  1,  1,  0,  0,  0,  1
 8: 1,  1,  5,  0,  1,  1,  0,  0,  4,  1
 9: 1,  1,  1,  0,  3,  2,  0,  0,  3,  1
10: 1,  0,  0,  0,  0,  0,  0,  0,  0,  1
11: 1,  0,  0,  0,  3,  1,  1,  0,  0,  1
12: 1,  0,  0,  0,  0,  0,  1,  0,  0,  1
13: 1,  5,  0,  0,  0,  0,  0,  0,  4,  1
14: 1,  1,  5,  0,  0,  0,  0,  4,  1,  1
15: 1,  1,  1,  0,  0,  0,  0,  1,  1,  1
//Drops
8
//Player
160.0, 364.0
//Goal
160.0, 65.0
//Lily pads
161.0, 420.0, 2
//Logs
160.0, 465.0, 0, 0
95.0, 160.0, 45, 1
225.0, 160.0, 135, 1
160.0, 18.0, 0, 0
