//  1,  2,  3,  4,  5,  6,  7,  8,  9, 10
 1: 1,  1,  1,  1,  1,  1,  1,  1,  1,  1
 2: 1,  0,  0,  0,  0,  0,  3,  1,  1,  1
 3: 1,  0,  0,  0,  0,  0,  0,  3,  1,  1
 4: 1,  0,  0,  0,  0,  0,  0,  0,  3,  1
 5: 1,  0,  0,  0,  0,  0,  0,  0,  0,  3
 6: 1,  0,  0,  0,  1,  5,  0,  0,  0,  0
 7: 1,  0,  0,  0,  1,  1,  5,  0,  0,  0
 8: 1,  5,  0,  0,  0,  3,  1,  0,  0,  0
 9: 1,  2,  0,  1,  1,  0,  1,  5,  0,  0
10: 2,  0,  4,  1,  1,  0,  0,  0,  0,  4
11: 0,  0,  3,  1,  1,  1,  5,  4,  0,  1
12: 0,  0,  0,  3,  1,  1,  1,  2,  0,  1
13: 0,  0,  0,  0,  1,  2,  0,  0,  4,  1
14: 0,  0,  0,  0,  1,  0,  0,  4,  1,  1
15: 0,  0,  0,  0,  1,  0,  4,  1,  1,  1
//Drops
11
//Player
60.0, 425.0
//Gole
195.0, 435.0
//Lily pads
 78.0, 370.0, 1
//Logs
 90.0, 90.0,-45, 0
200.0, 135.0,-45, 1
